11111111
1P000001
1000C001
100000E1
11111111
