1111111111111111111111111
1E0000000C00000C000000001
1010010000101001000000101
1010010010001001000000101
1P000000000000000000000C1
1111111111111111111111111