11111111111111111111111
1P0000000C0000000000001
10000010000011111111101
10000100000000000000101
100010000000000000C0101
10010000000000000000101
1010C000000011111111101
10111111111010000000001
10000010000010000000001
10000010000010000000001
10000010000011111111101
100000000000000000000E1
11111111111111111111111