11111111
11111111
11100000
11111111
