11111111111111111111111
1P00000000000000C000001
10111101110011110111101
10100001001010000100001
10111001110011100111001
10100001010010000100001
10100001001011110111101
1000C0000000000000000E1
11111111111111111111111
